SO xpms/wall_east.xpm

WE xpms/wall_north.xpm
 
NO xpms/wall_south.xpm
 
F 0,0,0
 
EA xpms/wall_west.xpm

C 25,20,22

1111111111111111111111111111111111111111111111111
1000111000000011000000000011000000000111 10000001
1000000000000000000011100000000000000000100000001
1000000000000001111100000000000000001100000000001
1000000111000000000000001100000000000000101100001
1000111000000011000000000011000000000111 10000001
1000000000111000011100011000111001111001111100001
1000000000000000000000001011100000000000000000001
1000000000000000000011100000100000000000000000001
1000000000000001111100001111000000011000000000011
1000000111000000000000001100000000000000101100001111111111111   1111111
1000111000000011000000000011000000000111 100000011000000000111 10000001
10000000001110000111000110001110011110011111000000111001111001111100001
10000000000000000000000000000000000000000000000000000000000000000000001
1000000000000000000011100000000000000000000000000000000000000000000001
100000000000000111110000000W000000001100000000000000000001100000000001
10000001110000000000000011000000000000000011000000000000000000001100001
11111111111111111111111111111111111111111111111111111111111111111111111

